9 9 64 2 4
444444444
400000004
401111104
401111104
401131104
401111104
401111104
400000004
444444444