11 11 64 2 2
44444444444
40000000004
40111111104
40000000104
40111110104
40100010104
40103110104
40100000104
40111111104
40000000004
44444444444