11 11 64 2 2
44444444444
40000000004
40112001104
40000000104
40111100204
40000300004
40000000004
40200000104
40110021104
40000000004
44444444444