17 17 64 2 2
44444444444444444
40000010011110004
40110010020000004
40120010000000004
40000010011120004
40000010010010004
41111120020010004
40000000011110004
40000000000000004
40211110020000004
40110210000000004
40100010000000004
40100010011100004
40120110013100004
40111120011100004
40000000000000004
44444444444444444