11 11 64 1 1
44444444444
41141114304
40111014114
40000014404
41110021104
44140000024
41120011114
40000044404
40000011104
40000000004
44444444444