15 15 64 2 2
444444444444444
400000000000004
401141111111104
401111141121104
400000004444404
400000004444404
400000001111104
400030001010104
400000002010204
400111001020404
400121004010104
400111002012104
400000000000004
400000000000004
444444444444444