75 50 64 3 3
444444444444444444444444444444444444444444444444444444444444444444444444444
400000000000000000000000000000000000000000000000000000000000000000000000004
400000000000000000000000000000000000000000000000000000000000000000000000004
400110000000111111111000111000000000000000000000000000000000000000000000004
400111120011111000111111102000000000000000000000000000000000000000000000004
400000000000000000000000000000000000000000000000000000000000000000000000004
400000000000000000000000000000000000000000000000000000000000000000000000004
400000000000000000000000001100000000000000000000000000000000000000000000004
400000000000000000000000001110000000000000000000000000000000000000000000004
400000000000000000000000001011000000000000000000000000000000000000000000004
400000000000000000000000001001000000000000000000000000000000000000000000004
400000000000000000000011101211000000000000000000000000000000000000000000004
400000000000000000000121000000000000000000000000000000000000000000000000004
400000000000000000000000000000000000000000000000000000000000000000000000004
400000000000000000000010000000000000000000000000000000000000000000000000004
400000000000000000000010000000000000000000000000000000000000000000000000004
400000000000000000000011001110000000111000000000000000000000000000000000004
400000000000000000000001100111120111101100000000000000000000000000000000004
400000000000000000000000120011111000001110000000000000000000000000000000004
400000000000000000000003000000000000000011110000000000000000000000000000004
400000000000000000000001100000000000001111000000000000000000000000000000004
400000000000000000000011000000000011111000000000000000000000000000000000004
400000000000000000000010000000011111000000000000001111000000000000000000004
400000000000000000000110000000011000000000000000001001111000000000000000004
400000000000000000001100000000001100000111000000011000002000000000000000004
400000000000000000000100000000000120011101200112001111000000000000000000004
400000000000000000000111000000000001110000000000000000001000000000000000004
400000000000000000000001000000000000000000011111000000001000000000000000004
400000000000000000011101000000000000000000011000000000001100000000000000004
400000000000000000010111000000001111000011110000000000001000000000000000004
400000000000000000011000000000011001111110000000000000001110000000000000004
400000000000000000001100000011101000110010000000000000000011001111000000004
400000000000000000001100000010001000111110000000000000000011001001100000004
400000000000000000011000000110011001100000001111110000000001001000200000004
400000000000000000001111000111001000000020111000110000000001001000000000004
400000000000000000000001110121111000000011100000100000000001011000000000004
400000000000000000000011000000001002111110000000100000000001111000100000004
400000000000000000000110100000000001111000000000111000000000000000100000004
400000000000000000000111100000000000011000000000001100000000000011100000004
400000000000000000000000100000000000001000000000000100000001100210000000004
400000000000000000000000200000000000001111000000211100000111001110000000004
400000000000000000000000110000000000000001000000000111011100111110000000004
400000000000000000000000011100000000000001110000000001110000000000000000004
400000000000000000000000000111000000000000110000000000000000000000000000004
400000000000000000000000000001100000000000010000000000000000000000000000004
400000000000000000000000000001000000011100011000000000000000000000000000004
400000000000000000000000000001100000000111001100000000000000000000000000004
400000000000000000000000000001110111000001111000000000000000000000000000004
400000000000000000000000000000011100000000000000000000000000000000000000004
444444444444444444444444444444444444444444444444444444444444444444444444444

